5 10
+-+-+-+-+-+
|        X|
+ + +-+-+ +
| | |     |
+ +-+ +-+ +
|   | |   |
+-+ + +-+-+
|   |   | |
+-+ + +-+ +
| |  *    |
+ + + + + +
|   | | | |
+ + + + + +
| | | | | |
+-+-+-+-+ +
| |     | |
+ + +-+-+ +
| | |     |
+ + +-+ +-+
|         |
+-+-+-+-+-+
